name Mappy McMapface
win 4
############################
#....#.............#.......#
#..#.#.G........E........###
#..#.#.............#.....###
#..#G#......#......#.....###
#...#......G#......#.....###
#...........#......#E.....##
#...........#......#...#..##
############################